#########
#       #
#########
#       #
#########
#       #
#########
#       #
#########