#########
#       #
####### #
#       #
# #######
#       #
# #######
#       #
#########