###########
#         #
# ####### #
# #     # #
# # ### # #
# # # # # #
# # # # # #
# # #   # #
# # ##### #
# #       #
###########